##########            ##########
######                    ######
########    ##$-$-##    ########
######[]    $-####$-    []######
##        $-########$-        ##
    @1$1    ########    $-@4
##    ##$-############$-##    ##
      ####################
      ####################
##    ##$-############$-##    ##
    @2$2    ########    $3@3
##        $-########$-        ##
######[]    $-####$-    []######
########    ##$-$-##    ########
######                    ######
##########            ##########
