##                                ##
    ##      []        []      ##
##  ##      ##        ##      ##  ##
    ######  ####    ####  ######
##########    ##    ##    ##########
########                    ########
######          ####          ######
######                        ######
######                        ######
######          ####          ######
########                    ########
##########    ##    ##    ##########
    ######  ####    ####  ######
##  ##      ##        ##      ##  ##
    ##      []        []      ##
##                                ##
####@2      $-  ####  $-      @3####
