  ######        ##                    ##        ######
  ####        ########    ####    ########        ####
            ######      ##    ##      ######@4
      ####@1          ##        ##            ####
##          ####  ######        ######  ####          ##
####[]####$-####  ##  ##        ##  ##  ####$-####[]####
################                        ################
############$-        ##  ####  ##        $-############
################  ##  ##        ##  ##  ################
################      ##        ##      ################
##############        ##        ##        ##############
############      ####    ####    ####      ############
############        ####  $-$-  ####        ############
##############                            ##############
##############                            ##############
############        ####  $-$-  ####        ############
############      ####    ####    ####      ############
##############        ##        ##        ##############
################      ##        ##      ################
################  ##  ##        ##  ##  ################
############$-        ##  ####  ##        $-############
################                        ################
####[]####$-####  ##  ##        ##  ##  ####$-####[]####
##          ####  ######        ######  ####          ##
      ####@2          ##        ##            ####
            ######      ##    ##      ######@3
  ####        ########    ####    ########        ####
  ######        ##                    ##        ######
