##########
##  ##  ##
##  ##  ##
##  ##  ##
##      ##
##########
